1111
1E01
1011
1011
1PC1
1111
